{
  "Width": 20,
  "Height": 20,
  "Level": [
    [ "####################" ],
    [ "#............#.....#" ],
    [ "#............#.....#" ],
    [ "#............#.....#" ],
    [ "#............#.....#" ],
    [ "#..................#" ],
    [ "#..................#" ],
    [ "#..................#" ],
    [ "#######............#" ],
    [ "#..................#" ],
    [ "#..................#" ],
    [ "#..................#" ],
    [ "#............#######" ],
    [ "#..###.............#" ],
    [ "#....#.............#" ],
    [ "#....#.............#" ],
    [ "#....#.............#" ],
    [ "#....#.............#" ],
    [ "#....#.............#" ],
    [ "####################" ]
  ],
  "RequiredFoodPoints": 8,
  "FoodCount": 1,
  "SnakePosX": 10,
  "SnakePosY": 10
}